2 10 3188 2990 2664 2662 2663 2696 2700 2709 2755 2667 
2 15 3188 3189 3001 2617 3016 110 2618 1753 2147 2636 2637 2638 3091 3092 3093 
2 5 2623 96 2652 2982 3188 
2 8 3188 2998 3007 3018 2136 2235 2901 2907 
2 10 2907 2966 2976 2979 3025 3028 3040 3127 3129 3154 
2 10 3093 2619 3064 3148 3149 3151 3181 3020 1730 3067 
1 6 3149 3150 3183 3182 3153 3154 
1 9 2623 2647 2971 2897 2977 2980 1732 2953 2951 
1 15 3093 3092 3090 2635 663 2630 2629 3009 3003 2995 2989 2988 2955 2952 2951 
1 3 1757 2959 179 
1 7 2667 2668 2669 2672 2674 2676 2679 
1 6 3154 3156 315 3152 3104 3105 
2 7 3117 3116 3113 3076 3074 3075 3072 
2 8 3117 3112 3118 3114 3147 3145 1745 3146 
3 4 434 3597 3598 3599 
3 2 434 3607 
2 4 434 3592 3587 3589 
1 3 3589 3580 3575 
2 4 3581 1761 3592 434 
1 8 3581 3577 3574 2931 2929 2918 2922 2923 
3 3 434 3610 3609 
1 3 3609 3613 3602 
1 5 2446 2531 2530 2529 2527 
1 4 2527 2599 2602 2601 
1 3 3602 2528 2527 
2 2 3609 3615 
1 5 2923 2919 2908 2915 2202 
1 6 3105 3161 3160 3159 3136 3139 
1 6 3105 3109 1744 2041 2932 2066 
1 6 3146 3172 1740 1743 3115 1744 
1 8 2907 2966 2978 3026 3032 3033 3031 3029 
1 4 3615 3619 3639 30 
