2 10 3188 2990 2664 2662 2663 2696 2700 2709 2755 2667 
2 15 3188 3189 3001 2617 3016 110 2618 1753 2147 2636 2637 2638 3091 3092 3093 
2 5 2623 96 2652 2982 3188 
2 8 3188 2998 3007 3018 2136 2235 2901 2907 
2 10 2907 2966 2976 2979 3025 3028 3040 3127 3129 3154 
2 10 3093 2619 3064 3148 3149 3151 3181 3020 1730 3067 
1 6 3149 3150 3183 3182 3153 3154 
1 4 2696 2693 2692 2627 
1 3 2696 2702 2712 
1 9 2623 2647 2971 2897 2977 2980 1732 2953 2951 
1 11 2951 2954 2956 2992 2999 3009 2629 2634 3090 3092 3093 
1 3 1757 2959 179 
1 2 2953 2954 
